11 80 19
################################################################################
#.#.#............................................Z.............................#
#.#.#.....................#...#.......................Z.......Z...Z......Z.....#
#.#....###...#...........................#.......#.......Z.....Z...Z..........Z#
#......#.#..#.#........#.....#....#.................................Z..........#
#......#.#..#.#..............#......................#.Z................Z.......#
#..................H.......................................Z.............Z.....#
#.............................#............#....#................Z.............#
#........................#......#...................Z.......#.....Z.......Z....#
#.......................................................Z......................#
################################################################################
