20 40 27
########################################
#.#.#..................................#
#.#.#..................................#
#.#......###...#.......................#
#........#.#..#.#......................#
#........#.#..#.#......................#
#......................................#
#......................................#
#......................................#
#...............................########
#...............................TTT.ZZZ#
#...............................TTT.ZZZ#
#...............................TTT.ZZZ#
#..............H................TTT.ZZZ#
#...............................TTT.ZZZ#
#...............................TTT.ZZZ#
#...............................TTT.ZZZ#
#...............................TTT.ZZZ#
#...............................TTT.ZZZ#
########################################