11 80 8
################################################################################
#.#.#.................................................D........................#
#.#.#.....................#...#.................................D..............#
#.#....###...#...........................#.......#......................D......#
#......#.#..#.#........#.....#....#.......................D....................#
#......#.#..#.#..............#......................#..................D.......#
#..................H...P.......................................D...............#
#.............................#............#....#..............................#
#........................#......#...........................#..........D.......#
#....................................................D.........................#
################################################################################
