20 40 21
########################################
#.#.#................Z.................#
#.#.#........................Z...Z.....#
#.#......###...#.....................Z.#
#........#.#..#.#...........Z..........#
#....Z...#.#..#.#...................####
#..............................Z...Z...#
#................Z.....................#
#.........#...............Z......Z.....#
#..Z.................................Z.#
#......................Z..........Z....#
#..........#...........................#
#......................................#
#....................Z....Z............#
#.............ZZ.......................#
#......................................#
#.......................Z......#.......#
#.H.........#..........................#
#..............................Z.......#
########################################