20 40 5
########################################
#......................................#
#......................................#
#.................T...........##.......#
#....T......................######.....#
#..........##.................##.......#
#......................................#
#.........+......T.....................#
#........................Z......T......#
#.........T............................#
#.............##....T.........Z........#
#.......Z.....##.............#.........#
#..T........H..........................#
#....................Z.......##........#
#............................#.........#
#.....T...Z......##....................#
#..........................T...........#
#...........T......#...................#
#..................#...................#
########################################