20 40 13
########################################
#.#.#..................................#
#.#.#..................D...............#
#.#......###...#........D..............#
#........#.#..#.#......................#
#........#.#..#.#......................#
#..............D.........D.............#
#.....D................................#
#...................D..................#
#........................D.............#
#.....D................................#
#......................................#
#........................D.............#
#.....D........H.......................#
#......................................#
#........................D.............#
#......................................#
#.............D.............D..........#
#......................................#
########################################