20 40 2
########################################
#......................................#
#.........................Z.......Z....#
#.................TT...................#
#....T.................................#
#......................................#
#......................................#
#................T.....................#
#..............................T.......#
#.........T............................#
#...................T..................#
#......................................#
#..T...................................#
#......................................#
#......................................#
#.....T................................#
#..........................T...........#
#..H........T..........................#
#......................................#
########################################