20 40 1
########################################
#.#.#..................................#
#.#.#.................###############..#
#.#......###...#....................#..#
#........#.#..#.#.........+.........#..#
#........#.#..#.#...................#..#
#...................................#..#
#...................................#..#
#...................................#..#
#...................H..................#
#......................................#
#.............##.......................#
#......................................#
#......................................#
##.....D.....................#.........#
###....................................#
#####................#.................#
######.................................#
#######.............................#..#
########################################