11 80 3
################################################################################
#.#.#.....................................................................D....#
#.#.#.....................#...#.........................................+......#
#.#....###...#...........................#.......#.............D........+......#
#......#.#..#.#........#.....#....#............................................#
#......#.#..#.#..............#......................#..........................#
#..................H....................................................+......#
#.............................#............#....#..............................#
#........................#......#...........................#..................#
#........................................................................D.....#
################################################################################
