20 40
########################################
#..................##........#.........#
#...T..............##........#.........#
#..................##........#.........#
#........H.........##........#.........#
#..................##........###########
#...D.....Z........##..................#
#..................##..................#
#..................##..................#
########################################
########################################
#..................##..................#
#..................##..................#
#..................##..................#
#..................##..................#
#..................##..................#
#..................##..................#
#..................##..................#
#..................##..................#
########################################