20 40
########################################
#......................................#
#..D...................................#
#......................................#
#......................................#
#......................................#
#......................................#
#......................................#
#......................................#
#...................H..................#
#......................................#
#......................................#
#......................................#
#......................................#
#......................................#
#......................................#
#......................................#
#......................................#
#......................................#
########################################