20 40
########################################
#..................##........#.........#
#..................##........#.........#
#..................##........#.........#
#..................##........#.........#
#..................##........###########
#..................##..................#
#..................##..................#
#..................##..................#
########################################
########################################
#..................##..................#
#..................##..................#
#..................##..................#
#..................##..................#
#..................##..................#
#..................##..................#
#..................##..................#
#..................##..................#
########################################